20 20
.........GDANSK.....
........*...........
........#...........
........#...........
*##################.
#SZCZECIN.........#.
#.................#.
##................#.
.############*#####.
.#...WARSZAWA.......
.#..................
.#############......
.#...........#......
.#..WROCLAW.##......
.#..*.......*.......
.####.......#KIELCE.
......*##.#########.
.OPOLE..#.*.......#.
........#.KRAKOW..#.
........###########.
2
KRAKOW GDANSK 10
WARSZAWA WROCLAW 3
3
KRAKOW GDANSK
WARSZAWA WROCLAW
SZCZECIN KRAKOW